albums:

sunny day service - sunny day service
Menneskekollektivet - lost girls
i hate myself - ten songs
musikalisches opfer - bac
Deep Dark Trench - christtt
Dynamite - stina nordenstam
acemo - all my life 2
mefitis - offscourings
vola - witness
ERIKA DE CASIER - SENSATIONAL
giant claw - mirror guide
Maria Arnal i Marcel Bag√©s - clamor
wasei jj chikada - Cyberia Layer:03
chase t - hikikomori party music
dj kuroneko - kuroneko
secede - tryshasla


)R&*yru(TKs2%kVx)fk2 pass 000webhiQ



moss icon - complete discog
red house painters - red house painters
captain beefheart - discog
animal collective - discog
xiu xiu - discog
swans - discog
the residents discog
mr bungle discog
xiu xiu discog
microphones glow pt 2
bjork - discog
nick cave let love in
ichiko aoba - live at ginza sony park

the pop group - y


choirs in the eye - kayo dot
gustavo cerati - bocanada
scott walker - bish bosch
st vincent - daddys home



pete la roca - basra
the field mice - snowball



ALBUMS



RICHARD WAGNER - DER RING DES NIBELUNGEN
MULATU ETHIOPIA







NEW DROPS


BLACK MIDI - CAVALCADE
SWEET TRIP ALBUM
unoverse 2
wifisfuneral - smoking mirrors
XIU XIU - plays from twin peaks
microphones - glow pt 2
let love in nick cave
asian glow - cull ficle



